0xB2BC20	WeaponLock
00 -NULL-	0x00
01 Bulbasaur Squirtle Venusaur Charmeleon Charmeleon 	0x0141CF6C
02 -EMPTY-	0x00
03 -EMPTY-	0x00
04 -EMPTY-	0x00
05 -EMPTY-	0x00
06 -EMPTY-	0x00
07 -EMPTY-	0x00
08 -EMPTY-	0x00
09 -EMPTY-	0x00
0A -EMPTY-	0x00
0B -EMPTY-	0x00
0C -EMPTY-	0x00
0D -EMPTY-	0x00
0E -EMPTY-	0x00
0F -EMPTY-	0x00
10 -EMPTY-	0x00
11 -EMPTY-	0x00
12 -EMPTY-	0x00
13 -EMPTY-	0x00
14 -EMPTY-	0x00
15 -EMPTY-	0x00
16 -EMPTY-	0x00
17 -EMPTY-	0x00
18 -EMPTY-	0x00
19 -EMPTY-	0x00
1A -EMPTY-	0x00
1B -EMPTY-	0x00
1C -EMPTY-	0x00
1D -EMPTY-	0x00
1E -EMPTY-	0x00
1F -EMPTY-	0x00
20 -EMPTY-	0x00
21 -EMPTY-	0x00
22 -EMPTY-	0x00
23 -EMPTY-	0x00
24 -EMPTY-	0x00
25 -EMPTY-	0x00
26 -EMPTY-	0x00
27 Charmander Charmeleon Charizard Charmander Charmeleon 	0x0141CF74
28 -EMPTY-	0x00
29 -EMPTY-	0x00
2A -EMPTY-	0x00
2B -EMPTY-	0x00
2C -EMPTY-	0x00
2D -EMPTY-	0x00
2E -EMPTY-	0x00
2F -EMPTY-	0x00
30 Bulbasaur Ivysaur Venusaur Squirtle Wartortle Blastoise Caterpie Metapod Butterfree Weedle Kakuna Beedrill Pidgey Pigeotto Pidgeot Rattata Raticate Spearow Fearow Ekans Arbok Pikachu Raichu Sandshrew Sandslash Nidoran-F Nidorina Nidoqueen Nidoran-M Nidorino Nidoking Venusaur Venusaur Venusaur 	0x01444A2C
31 -EMPTY-	0x00
32 -EMPTY-	0x00
33 -EMPTY-	0x00
34 -EMPTY-	0x00
35 Charmander Charmeleon Charizard Vulpix Ninetales Growlithe Arcanine Ponyta Rapidash Magmar Flareon Moltres 	0x014B99D4
36 Hitmonchan Magmar Dragonite Charmander Charmeleon Charizard Nidoqueen Nidoking Clefairy Clefable Jigglypuff Wigglytuff Mankey Primeape Abra Kadabra Alakazam Machop Machoke Machamp Geodude Graveller Golem Grimer Muk Gastly Haunter Gengar Drowzee Hypno Cubone Marowak Lickitung Rhydon Chansey Kangaskhan Mr. Mime Electabuzz Snorlax Mewtwo Mew Bulbasaur Bulbasaur Bulbasaur Bulbasaur Bulbasaur Bulbasaur Bulbasaur Bulbasaur Bulbasaur Bulbasaur Bulbasaur Bulbasaur Bulbasaur 	0x014B9A14
37 Growlithe Arcanine Ponyta Rapidash 	0x014BA6E4
38 -EMPTY-	0x00
39 Charmander Charmeleon Charizard Vulpix Ninetales Growlithe Arcanine Magmar Flareon Moltres Nidoqueen Nidoking Clefairy Clefable Jigglypuff Wigglytuff Machop Machoke Machamp Geodude Graveller Golem Ponyta Rapidash Slowpoke Slowbro Grimer Muk Cubone Marowak Lickitung Koffing Weezing Rhyhorn Rhydon Chansey Kangaskhan Tauros Gyarados Aerodactyl Snorlax Dratini Dragonair Dragonite Mewtwo Mew 	0x014BA70C
3A Charmander Charmeleon Charizard Vulpix Ninetales Ponyta Rapidash Magmar Flareon Moltres Growlithe Arcanine Mew 	0x014BA748
3B Vulpix Ninetales Ponyta Rapidash Magmar Flareon Charmander Charmeleon Charizard Nidoqueen Nidoking Clefairy Clefable Jigglypuff Wigglytuff Growlithe Arcanine Machop Machoke Machamp Geodude Graveller Golem Slowpoke Slowbro Grimer Muk Cubone Marowak Lickitung Koffing Weezing Rhyhorn Rhydon Chansey Kangaskhan Tauros Gyarados Aerodactyl Snorlax Moltres Dratini Dragonair Dragonite Mewtwo Mew 	0x014BA79C
3C -EMPTY-	0x00
3D Squirtle Wartortle Blastoise Poliwag Poliwhirl Poliwrath Krabby Kingler Horsea Seadra Tentacool Tentacruel Staryu Starmie 	0x014C26E0
3E Squirtle Wartortle Blastoise Psyduck Golduck Poliwag Poliwhirl Poliwrath Tentacool Tentacruel Slowpoke Slowbro Shellder Cloyster Krabby Kingler Horsea Seadra Staryu Starmie Lapras Vaporeon Omanyte Omastar Rattata Raticate Nidorina Nidoqueen Nidorino Nidoking Clefairy Clefable Jigglypuff Wigglytuff Meowth Persian Seel Dewgong Cubone Marowak Lickitung Rhydon Chansey Kangaskhan Goldeen Seaking Jynx Gyarados Kabuto Kabutops Snorlax Articuno Dratini Dragonair Dragonite Mewtwo Mew 	0x014BA838
3F Shellder Cloyster 	0x014BA878
40 Krabby Kingler 	0x014BA880
41 Squirtle Wartortle Blastoise Poliwag Poliwhirl Poliwrath Tentacool Tentacruel Krabby Kingler Horsea Seadra Staryu Starmie Shellder Cloyster Omanyte Omastar Kabuto Kabutops Rattata Raticate Nidorina Nidoqueen Nidorino Nidoking Clefairy Clefable Jigglypuff Wigglytuff Meowth Persian Psyduck Golduck Slowpoke Slowbro Seel Dewgong Cubone Marowak Lickitung Rhydon Chansey Kangaskhan Goldeen Seaking Jynx Gyarados Lapras Vaporeon Snorlax Articuno Dratini Dragonair Dragonite Mewtwo Mew 	0x014BA8BC
42 Squirtle Wartortle Blastoise Psyduck Golduck Poliwag Poliwhirl Poliwrath Tentacool Tentacruel Shellder Cloyster Horsea Seadra Staryu Starmie Gyarados Lapras Vaporeon Omanyte Omastar Kabuto Kabutops Slowpoke Slowbro Kingler Lickitung Rhydon Kangaskhan Goldeen Seaking Snorlax Dratini Dragonair Dragonite Mew 	0x014BA93C
43 Psyduck Golduck Tentacool Tentacruel Slowpoke Slowbro Staryu Starmie Lapras Pikachu Raichu Nidoqueen Nidoking Poliwag Poliwhirl Poliwrath Seel Dewgong Shellder Cloyster Krabby Kingler Lickitung Rhydon Kangaskhan Horsea Seadra Goldeen Seaking Tauros Gyarados Vaporeon Omanyte Omastar Kabuto Kabutops Snorlax Dratini Dragonair Dragonite Mew 	0x014BA970
44 Seel Dewgong Horsea Seadra Goldeen Seaking Gyarados Squirtle Wartortle Blastoise Psyduck Golduck Poliwag Poliwhirl Poliwrath Tentacool Tentacruel Staryu Starmie Lapras Vaporeon Omanyte Omastar Kabuto Kabutops Dratini Dragonair Dragonite Mew 	0x014BA9AC
45 Squirtle Wartortle Blastoise Slowbro Shellder Cloyster Omanyte Omastar 	0x014BA9F4
46 Zubat Golbat Oddish Gloom Vileplume Paras Parasect Exeggcute Exeggutor Tangela Kabuto Kabutops 	0x01444A98
47 Bulbasaur Ivysaur Venusaur Parasect Exeggcute Exeggutor Tangela Oddish Gloom Vileplume Paras 	0x014BAA14
48 Oddish Gloom Vileplume Exeggcute Exeggutor Tangela Kabuto Kabutops Bulbasaur Ivysaur Venusaur Butterfree Beedrill Ekans Arbok Zubat Golbat Paras Parasect Venonat Venomoth Bellsprout Weepinbell Victreebel Tentacool Tentacruel Grimer Muk Gastly Haunter Gengar Mew 	0x014BAA44
49 Venusaur Oddish Gloom Vileplume 	0x014BAA78
4A Bulbasaur Ivysaur Venusaur Oddish Gloom Vileplume Bellsprout Weepinbell Victreebel Farfetch'd 	0x014BAB10
4B -EMPTY-	0x00
4C -EMPTY-	0x00
4D -EMPTY-	0x00
4E -EMPTY-	0x00
4F -EMPTY-	0x00
50 -EMPTY-	0x00
51 -EMPTY-	0x00
52 -EMPTY-	0x00
53 -EMPTY-	0x00
54 -EMPTY-	0x00
55 -EMPTY-	0x00
56 -EMPTY-	0x00
57 -EMPTY-	0x00
58 -EMPTY-	0x00
59 -EMPTY-	0x00
5A -EMPTY-	0x00
5B -EMPTY-	0x00
5C -EMPTY-	0x00
5D -EMPTY-	0x00
5E -EMPTY-	0x00
5F -EMPTY-	0x00
60 -EMPTY-	0x00
61 -EMPTY-	0x00
62 -EMPTY-	0x00
63 -EMPTY-	0x00
64 -EMPTY-	0x00
65 -EMPTY-	0x00
66 -EMPTY-	0x00
67 -EMPTY-	0x00
68 -EMPTY-	0x00
69 -EMPTY-	0x00
6A -EMPTY-	0x00
6B -EMPTY-	0x00
6C -EMPTY-	0x00
6D -EMPTY-	0x00
6E -EMPTY-	0x00
6F -EMPTY-	0x00
70 -EMPTY-	0x00
71 -EMPTY-	0x00
72 -EMPTY-	0x00
73 -EMPTY-	0x00
74 -EMPTY-	0x00
75 -EMPTY-	0x00
76 -EMPTY-	0x00
77 -EMPTY-	0x00
78 -EMPTY-	0x00
79 -EMPTY-	0x00
7A -EMPTY-	0x00
7B -EMPTY-	0x00
7C -EMPTY-	0x00
7D -EMPTY-	0x00
7E -EMPTY-	0x00
7F -EMPTY-	0x00
80 -EMPTY-	0x00
81 Victreebel Farfetch'd Mew 	0x014BAA94
82 Bulbasaur Ivysaur Venusaur Butterfree Oddish Gloom Vileplume Paras Parasect Venonat Venomoth Bellsprout Weepinbell Victreebel Exeggcute Exeggutor Tangela 	0x014BAAA4
83 Bulbasaur Ivysaur Venusaur Oddish Gloom Vileplume Exeggcute Exeggutor Moltres Charizard Butterfree Beedrill Clefairy Clefable Ninetales Jigglypuff Wigglytuff Paras Parasect Venonat Venomoth Arcanine Bellsprout Weepinbell Victreebel Ponyta Rapidash Lickitung Chansey Tangela Kangaskhan Mr. Mime Tauros Lapras Porygon Snorlax Mewtwo Mew 	0x014BAADC
84 Bulbasaur Ivysaur Venusaur Oddish Gloom Vileplume Bellsprout Weepinbell Victreebel Farfetch'd 	0x014BAB10
85 Bulbasaur Ivysaur Venusaur Bellsprout Weepinbell Victreebel Tangela 	0x014BAB30
86 Pikachu Raichu Magnemite Magneton Electabuzz Jolteon Zapdos Rattata Raticate Nidoran-F Nidorina Nidoqueen Nidoran-M Nidorino Nidoking Clefairy Clefable Jigglypuff Wigglytuff Meowth Persian Mankey Primeape Grimer Muk Gastly Haunter Gengar Voltorb Electrode Lickitung Koffing Weezing Rhyhorn Rhydon Chansey Kangaskhan Staryu Starmie Mr. Mime Tauros Gyarados Lapras Porygon Snorlax Dratini Dragonair Dragonite Mewtwo Mew 	0x014BABC8
87 Raichu Hitmonchan Electabuzz Dragonite Charmander Charmeleon Charizard Pikachu Nidoqueen Nidoking Clefairy Clefable Jigglypuff Wigglytuff Mankey Primeape Abra Kadabra Alakazam Machop Machoke Machamp Geodude Graveller Golem Grimer Muk Gastly Haunter Gengar Drowzee Hypno Cubone Marowak Lickitung Rhydon Chansey Kangaskhan Mr. Mime Magmar Snorlax Dragonite Mewtwo Mew 	0x014BAC5C
88 -EMPTY-	0x00
89 -EMPTY-	0x00
8A -EMPTY-	0x00
8B Pikachu Raichu Magnemite Magneton Voltorb Electrode Electabuzz Jolteon Porygon Zapdos 	0x014BBCA8
8C -EMPTY-	0x00
8D Pikachu Raichu Magnemite Magneton Voltorb Electrode Electabuzz Zapdos Rattata Raticate Nidoran-F Nidorina Nidoqueen Nidoran-M Nidorino Nidoking Clefairy Clefable Jigglypuff Wigglytuff Meowth Persian Mankey Primeape Grimer Muk Gastly Haunter Gengar Lickitung Koffing Weezing Rhyhorn Rhydon Kangaskhan Staryu Starmie Mr. Mime Tauros Gyarados Lapras Porygon Snorlax Dratini Dragonair Dragonite Mewtwo Mew 	0x014BACCC
8E Pikachu Raichu 	0x014BAD00
8F Seel Dewgong Shellder Cloyster Vaporeon Tentacool Tentacruel Horsea Seadra Staryu Starmie Lapras Omanyte Omastar Kabuto Kabutops 	0x014BAD1C
90 Jynx Lapras Articuno Squirtle Wartortle Blastoise Rattata Raticate Nidoran-F Nidorina Nidoqueen Nidoran-M Nidorino Nidoking Clefairy Clefable Jigglypuff Wigglytuff Psyduck Golduck Poliwag Poliwhirl Poliwrath Tentacool Tentacruel Slowpoke Slowbro Seel Dewgong Shellder Cloyster Krabby Kingler Cubone Marowak Lickitung Rhyhorn Rhydon Chansey Kangaskhan Horsea Seadra Goldeen Seaking Staryu Starmie Tauros Gyarados Vaporeon Porygon Omanyte Omastar Kabuto Kabutops Snorlax Dratini Dragonair Dragonite Mewtwo Mew 	0x014BADA8
91 Ekans Arbok Zubat Golbat Poliwrath Tentacruel Muk Gengar Koffing Weezing Vaporeon Squirtle Wartortle Blastoise Poliwag Poliwhirl Tentacool Doduo Dodrio Grimer Gastly Haunter Krabby Kingler Goldeen Seaking Omanyte Omastar Dratini Dragonair Dragonite Articuno 	0x014BAE2C
92 Seel Dewgong Shellder Cloyster Lapras Articuno Squirtle Wartortle Blastoise Rattata Raticate Nidoran-F Nidorina Nidoqueen Nidoran-M Nidorino Nidoking Clefairy Clefable Jigglypuff Wigglytuff Psyduck Golduck Poliwag Poliwhirl Poliwrath Tentacool Tentacruel Slowpoke Slowbro Krabby Kingler Cubone Marowak Lickitung Rhyhorn Rhydon Chansey Kangaskhan Horsea Seadra Goldeen Seaking Staryu Starmie Jynx Tauros Gyarados Vaporeon Porygon Omanyte Omastar Kabuto Kabutops Snorlax Dratini Dragonair Dragonite Mewtwo Mew 	0x014BAECC
93 Hitmonchan Jynx Squirtle Wartortle Blastoise Nidoqueen Nidoking Clefairy Clefable Jigglypuff Wigglytuff Psyduck Golduck Mankey Primeape Poliwhirl Poliwrath Abra Kadabra Alakazam Machop Machoke Machamp Slowbro Grimer Muk Gastly Haunter Gengar Drowzee Hypno Lickitung Rhydon Chansey Kangaskhan Mr. Mime Electabuzz Snorlax Dragonite Mewtwo Mew 	0x014BAF40
94 Jynx Blastoise Nidoqueen Nidoking Slowbro Dewgong Shellder Cloyster Rhydon Kangaskhan Starmie Gyarados Lapras Articuno Mewtwo Mew 	0x014BAF78
95 Mankey Primeape Machop Machoke Machamp 	0x01444AB0
96 Charizard Raticate Sandslash Nidoqueen Nidoking Primeape Machamp Hitmonchan Rhydon Charmander Charmeleon Squirtle Wartortle Blastoise Clefairy Clefable Jigglypuff Wigglytuff Psyduck Golduck Mankey Poliwhirl Poliwrath Abra Kadabra Alakazam Machop Machoke Geodude Graveller Golem Slowbro Gengar Drowzee Hypno Cubone Marowak Hitmonlee Lickitung Chansey Kangaskhan Mr. Mime Jynx Electabuzz Magmar Snorlax Mewtwo Mew Rattata Sandshrew Nidoran-F Nidorina Nidoran-M Nidorino Paras Parasect Rhyhorn Scyther Pikachu Raichu 	0x014BB058
97 -EMPTY-	0x00
98 -EMPTY-	0x00
99 -EMPTY-	0x00
9A -EMPTY-	0x00
9B -EMPTY-	0x00
9C -EMPTY-	0x00
9D -EMPTY-	0x00
9E -EMPTY-	0x00
9F -EMPTY-	0x00
A0 -EMPTY-	0x00
A1 Pikachu Raichu Nidoran-F Nidorina Nidoqueen Nidoran-M Nidorino Nidoking Ponyta Rapidash Hitmonlee Eevee Vaporeon Jolteon Flareon Growlithe Arcanine Cubone Marowak 	0x014BB0A0
A2 -EMPTY-	0x00
A3 -EMPTY-	0x00
A4 -EMPTY-	0x00
A5 -EMPTY-	0x00
A6 -EMPTY-	0x00
A7 Hitmonlee 	0x014BB0B8
A8 Doduo Dodrio Hitmonlee 	0x014BB0C0
A9 Mankey Primeape Poliwag Poliwhirl Poliwrath Machop Machoke Machamp Hitmonlee Electabuzz Magmar Golduck Ponyta Rapidash Exeggutor Cubone Marowak Hitmonchan Kangaskhan Mewtwo Mew 	0x014BB0E8
AA Hitmonlee Machop Machoke Machamp 	0x014BB108
AB Mankey Primeape Machop Machoke Machamp Pinsir Charmander Charmeleon Charizard Squirtle Wartortle Blastoise Pikachu Raichu Sandshrew Sandslash Nidoqueen Nidoking Clefairy Clefable Jigglypuff Wigglytuff Psyduck Golduck Poliwhirl Poliwrath Abra Kadabra Alakazam Geodude Graveller Golem Slowbro Gengar Drowzee Hypno Cubone Marowak Hitmonlee Hitmonchan Lickitung Rhydon Chansey Kangaskhan Mr. Mime Electabuzz Magmar Omastar Kabutops Snorlax Mewtwo Mew 	0x014BB14C
AC Poliwrath Machop Machoke Machamp Pinsir Charmander Charmeleon Charizard Squirtle Wartortle Blastoise Pikachu Raichu Sandshrew Sandslash Nidoqueen Nidoking Clefairy Clefable Jigglypuff Wigglytuff Psyduck Golduck Mankey Primeape Poliwhirl Abra Kadabra Alakazam Geodude Graveller Golem Slowbro Gengar Drowzee Hypno Cubone Marowak Hitmonlee Hitmonchan Lickitung Rhydon Chansey Kangaskhan Mr. Mime Jynx Electabuzz Magmar Omastar Kabutops Snorlax Mewtwo Mew 	0x014BB1B8
AD Ekans Arbok Oddish Gloom Vileplume Bellsprout Weepinbell Tentacool Tentacruel Lickitung Weedle Kakuna Bulbasaur Ivysaur Venusaur 	0x014BD8DC
AE Grimer Muk Gastly Haunter Gengar Drowzee Hypno Koffing Weezing 	0x014BB200
AF Bulbasaur Ivysaur Venusaur Butterfree Oddish Gloom Vileplume Paras Parasect Venonat Venomoth Bellsprout Weepinbell Victreebel Exeggcute Exeggutor Tangela 	0x014BB214
B0 Weedle Kakuna Beedrill Sandshrew Sandslash Nidoran-F Nidorina Nidoqueen Nidoran-M Nidorino Nidoking Tentacool Tentacruel Ekans Arbok Grimer Muk Venusaur Venusaur Venusaur Venusaur Venusaur Venusaur Venusaur 	0x014BC7F8
B1 Grimer Muk Koffing Weezing Bulbasaur Ivysaur Venusaur 	0x014BB254
B2 Gastly Haunter Gengar Koffing Weezing Magmar Flareon 	0x014BB274
B3 Beedrill Ekans Arbok Nidoran-M Nidorino Nidoking Bellsprout Weepinbell Victreebel Tentacool Tentacruel Rapidash Farfetch'd Seaking Sandshrew Sandslash Nidoran-F Nidorina Nidoqueen Mankey Primeape Poliwrath Machop Machoke Machamp Grimer Muk Cloyster Gastly Haunter Gengar Hitmonlee Rhyhorn Rhydon Goldeen Mewtwo Mew 	0x014BB2A0
B4 Ekans Arbok Nidoran-F Nidorina Nidoqueen Nidoran-M Nidorino Nidoking Zubat Golbat Oddish Gloom Vileplume Grimer Muk Gastly Haunter Gengar Koffing Weezing 	0x014BB2EC
B5 Sandshrew Sandslash Diglett Dugtrio Onix Charmander Charmeleon Charizard Squirtle Wartortle Blastoise Rattata Raticate Ekans Arbok Pikachu Raichu Nidoran-F Nidorina Nidoqueen Nidoran-M Nidorino Nidoking Clefairy Clefable Vulpix Ninetales Jigglypuff Wigglytuff Paras Parasect Meowth Persian Psyduck Golduck Mankey Primeape Growlithe Arcanine Poliwag Poliwhirl Poliwrath Kadabra Alakazam Machop Machoke Machamp Geodude Graveller Golem Slowpoke Slowbro Grimer Muk Onix Krabby Kingler Cubone Marowak Lickitung Rhyhorn Rhydon Kangaskhan Pinsir Eevee Vaporeon Jolteon Flareon Kabuto Kabutops Mew 	0x014BB340
B6 Cubone Marowak 	0x014BB394
B7 -EMPTY-	0x00
B8 -EMPTY-	0x00
B9 -EMPTY-	0x00
BA -EMPTY-	0x00
BB -EMPTY-	0x00
BC Cubone Marowak 	0x014BB39C
BD Sandshrew Sandslash Diglett Dugtrio Geodude Graveller Golem Onix Rhyhorn Rhydon Venusaur Charizard Blastoise Ekans Arbok Nidoqueen Nidoking Mankey Primeape Poliwhirl Poliwrath Machop Machoke Machamp Slowpoke Slowbro Onix Cubone Marowak Hitmonlee Hitmonchan Lickitung Chansey Kangaskhan Pinsir Tauros Gyarados Aerodactyl Snorlax Dragonite Mewtwo Mew 	0x014BB3AC
BE Diglett Dugtrio Lapras Snorlax Charizard Blastoise Ekans Arbok Sandshrew Sandslash Nidoqueen Nidoking Poliwhirl Poliwrath Machop Machoke Machamp Geodude Graveller Golem Slowpoke Slowbro Onix Cubone Marowak Lickitung Rhyhorn Rhydon Kangaskhan Tauros Snorlax Mew 	0x014BB420
BF Sandshrew Sandslash Diglett Dugtrio Geodude Graveller Golem Lickitung Rhyhorn Rhydon 	0x014BB44C
C0 Nidoqueen Nidoking Diglett Dugtrio Poliwag Poliwhirl Poliwrath Venusaur Sandshrew Sandslash Onix Cubone Marowak Rhyhorn Rhydon Mew Geodude Graveller Golem Omanyte Omastar Kabuto Kabutops Aerodactyl 	0x014BB484
C1 Spearow Fearow Doduo Dodrio Zapdos 	0x01444B20
C2 Aerodactyl Charizard Pidgey Pigeotto Pidgeot Spearow Fearow Zubat Golbat Farfetch'd Doduo Dodrio Articuno Zapdos Moltres Dragonite Mew Pikachu 	0x014BB4AC
C3 Butterfree Pidgey Pigeotto Pidgeot Venomoth Articuno Zubat Farfetch'd 	0x014BB4CC
C4 Beedrill Spearow Fearow Nidoran-M Nidorino Nidoking Farfetch'd Doduo Dodrio Goldeen Seaking Articuno Zapdos Moltres Seel Dewgong Pidgey Pigeotto Pidgeot 	0x014BBCC0
C5 Pidgeot Fearow Farfetch'd Articuno Zapdos Moltres Spearow Pidgey Pigeotto Doduo Dodrio Aerodactyl Mew 	0x014BB50C
C6 Pidgey Pigeotto Pidgeot Spearow Fearow Farfetch'd Dodrio Doduo 	0x014BB52C
C7 Charizard Pidgey Pigeotto Pidgeot Zubat Golbat Scyther Aerodactyl Moltres Dragonite 	0x014BB540
C8 Beedrill Pidgey Pigeotto Pidgeot Spearow Fearow Pikachu Raichu Sandshrew Sandslash Venomoth Diglett Dugtrio Growlithe Arcanine Ponyta Rapidash Farfetch'd Doduo Dodrio Kingler Hitmonchan Horsea Seadra Goldeen Seaking Scyther Jolteon Porygon Aerodactyl Articuno Zapdos Moltres Dratini Dragonair Dragonite Mewtwo Vulpix Ninetales Krabby Starmie Mew Paras Parasect Venonat 	0x014BB5A4
C9 Venusaur Clefairy Clefable Persian Psyduck Golduck Poliwag Poliwhirl Poliwrath Slowpoke Slowbro Kingler Tangela Snorlax Mewtwo Mew Bulbasaur Ivysaur Sandshrew Sandslash Meowth Krabby Lickitung Nidoran-M Nidorino Nidoking 	0x014BB5FC
CA Alakazam Tentacool Tentacruel Cloyster Hypno Mr. Mime Porygon Mewtwo Mew Abra Kadabra Shellder Drowzee Staryu Starmie 	0x014BB630
CB Butterfree Venonat Venomoth Psyduck Golduck Kadabra Alakazam Slowpoke Slowbro Drowzee Hypno Exeggcute Exeggutor Tangela Mr. Mime Jynx Mewtwo Mew Abra 	0x014BB650
CC Gastly Haunter Gengar Drowzee Hypno Butterfree Clefairy Clefable Ninetales Jigglypuff Wigglytuff Venomoth Meowth Persian Abra Kadabra Alakazam Slowpoke Slowbro Exeggcute Exeggutor Lickitung Chansey Starmie Mr. Mime Jynx Lapras Porygon Mewtwo Mew Butterfree 	0x014BB688
CD Ninetales Persian Poliwag Poliwhirl Poliwrath Rapidash Gastly Haunter Gengar Drowzee Hypno Exeggcute Exeggutor Vulpix Zubat Golbat Meowth Psyduck Golduck Ponyta Mr. Mime Mew 	0x014BB6D4
CE Pikachu Raichu Clefairy Clefable Magnemite Magneton Voltorb Electrode Chansey Staryu Starmie Mr. Mime Electabuzz Zapdos Bulbasaur Ivysaur Venusaur Jigglypuff Wigglytuff Paras Parasect Psyduck Golduck Abra Kadabra Alakazam Machop Machoke Machamp Slowpoke Slowbro Cloyster Drowzee Hypno Exeggcute Exeggutor Scyther Jynx Jolteon Dratini Dragonair Dragonite Mewtwo Mew 	0x014BB740
CF Kadabra Alakazam Exeggcute Exeggutor Mr. Mime Articuno Pikachu Raichu Venusaur Clefairy Clefable Jigglypuff Wigglytuff Abra Bellsprout Weepinbell Victreebel Magnemite Magneton Drowzee Hypno Tangela Staryu Starmie Jynx Articuno Dragonite Mewtwo Mew 	0x014BB7F4
D0 Butterfree Venonat Venomoth Psyduck Golduck Kadabra Alakazam Drowzee Hypno Exeggcute Exeggutor Weezing Seaking Staryu Starmie Mr. Mime Porygon Mewtwo Mew Paras Parasect Koffing Goldeen 	0x014BB870
D1 Venonat Venomoth Kadabra Alakazam Slowpoke Slowbro Drowzee Hypno Exeggcute Exeggutor Staryu Starmie Mr. Mime Jynx Mewtwo Mew Butterfree Clefairy Clefable Jigglypuff Wigglytuff Venonat Psyduck Golduck Poliwag Poliwhirl Poliwrath Abra Gastly Haunter Gengar Chansey Electabuzz Magmar Lapras Porygon Snorlax Mewtwo Mew 	0x014BB894
D2 -EMPTY-	0x00
D3 -EMPTY-	0x00
D4 Geodude Graveller Golem Onix Rhyhorn Rhydon Omanyte Omastar Kabuto Kabutops Aerodactyl Charmander Charmeleon Charizard Squirtle Wartortle Blastoise Ekans Arbok Sandshrew Sandslash Nidoqueen Nidoking Diglett Dugtrio Mankey Primeape Poliwrath Machop Machoke Machamp Grimer Muk Krabby Kingler Cubone Marowak Hitmonlee Hitmonchan Lickitung Chansey Kangaskhan Pinsir Tauros Snorlax Dragonite Mewtwo Mew 	0x014BB8C0
D5 Geodude Graveller Golem Onix Rhyhorn Rhydon Omanyte Omastar Kabuto Kabutops Aerodactyl 	0x014BB8FC
D6 Tangela Omanyte Omastar Kabuto Kabutops Aerodactyl Articuno Zapdos Moltres Mewtwo Mew Charmander Charmeleon Charizard Diglett Dugtrio Krabby Kingler Exeggcute Exeggutor Cubone Marowak Lapras Geodude Graveller Golem Onix Rhyhorn Rhydon 	0x014BB950
D7 Onix Charmander Charmeleon Charizard Squirtle Wartortle Blastoise Ekans Arbok Sandshrew Sandslash Nidoqueen Nidoking Diglett Dugtrio Mankey Primeape Poliwrath Machop Machoke Machamp Geodude Graveller Golem Grimer Muk Krabby Kingler Cubone Marowak Hitmonlee Hitmonchan Lickitung Rhyhorn Rhydon Chansey Kangaskhan Pinsir Tauros Omanyte Omastar Kabuto Kabutops Aerodactyl Snorlax Dragonite Mewtwo Mew 	0x014BB9B0
D8 Sandshrew Sandslash Jigglypuff Wigglytuff Geodude Graveller Golem Voltorb Electrode Lickitung Omanyte Omastar Snorlax Squirtle Wartortle Blastoise Pikachu Raichu Clefairy Clefable Magnemite Magneton Exeggcute Exeggutor Koffing Weezing Rhyhorn Rhydon Chansey Kabuto Kabutops Mew Staryu Starmie 	0x014BBA20
D9 -EMPTY-	0x00
DA Vulpix Ninetales Zubat Golbat Gastly Haunter Gengar Staryu Starmie Magmar Lapras Kabutops Mewtwo Psyduck Golduck Tentacool Tentacruel Mr. Mime Kabuto 	0x0145BE88
DB Gastly Haunter Gengar Lickitung Jynx Snorlax Seel Dewgong Grimer Muk 	0x014BBA4C
DC Kadabra Alakazam Gastly Haunter Gengar Mew 	0x014BBA6C
DD Gastly Haunter Gengar Hypno Charmeleon Butterfree Clefairy Clefable Jigglypuff Wigglytuff Meowth Persian Abra Kadabra Alakazam Slowpoke Slowbro Exeggcute Exeggutor Lickitung Starmie Mr. Mime Jynx Lapras Porygon Mewtwo Mew 	0x014BBAB0
DE Gastly Haunter Gengar Butterfree Rattata Raticate Nidoqueen Nidoking Clefairy Clefable Ninetales Jigglypuff Wigglytuff Zubat Golbat Meowth Persian Abra Kadabra Alakazam Slowpoke Slowbro Grimer Muk Drowzee Hypno Lickitung Koffing Weezing Chansey Kangaskhan Mr. Mime Jynx Eevee Vaporeon Jolteon Flareon Porygon Snorlax Mewtwo Mew 	0x014BBAF0
DF Haunter Gengar Grimer Muk 	0x014BBB2C
E0 Charizard Charmander Charmeleon Aerodactyl Dragonite Mew 	0x014BBB4C
E1 Horsea Seadra Gyarados Dratini Dragonair Dragonite Charmander Charmeleon Charizard Onix Lapras Aerodactyl Mew 	0x014BBB5C
E2 Charmander Charmeleon Charizard Gyarados Dratini Dragonair Dragonite Horsea Seadra Growlithe Arcanine Lapras Aerodactyl Mew 	0x014BBB80
E3 Charmander Charmeleon Charizard Onix Horsea Seadra Aerodactyl Dratini Dragonair Dragonite Growlithe Arcanine Gyarados Lapras Mew 	0x014BBBA0
E4 Beedrill Mankey Primeape Growlithe Arcanine Kangaskhan Tauros Gyarados Dratini Dragonair Dragonite Bulbasaur Ivysaur Venusaur Charmander Charmeleon Charizard Squirtle Wartortle Blastoise Nidoqueen Nidoking Marowak Rhydon Horsea Seadra Pinsir Lapras Snorlax Mew 	0x014BBBF8
E5 Pidgey Pigeotto Pidgeot Horsea Seadra Gyarados Dratini Dragonair Dragonite Charizard Butterfree Spearow Fearow Zubat Golbat Venomoth Farfetch'd Onix Staryu Starmie Aerodactyl Articuno Zapdos Moltres Mew 	0x014BBC38
E6 -EMPTY-	0x00
E7 -EMPTY-	0x00
E8 -EMPTY-	0x00
E9 -EMPTY-	0x00
EA -EMPTY-	0x00
EB -EMPTY-	0x00
EC -EMPTY-	0x00
ED Caterpie Metapod Butterfree Weedle Kakuna 	0x014BE38C
EE -EMPTY-	0x00
EF -EMPTY-	0x00
F0 -EMPTY-	0x00
F1 -EMPTY-	0x00
F2 Pikachu Raichu Magnemite Magneton Electabuzz Jolteon Porygon Zapdos Dratini Dragonair Dragonite Rattata Raticate Clefairy Clefable Jigglypuff Wigglytuff Abra Kadabra Alakazam Slowpoke Slowbro Drowzee Hypno Voltorb Electrode Chansey Staryu Starmie Mr. Mime Gyarados Mewtwo Mew 	0x014BAC94
F3 Mr. Mime Bulbasaur Ivysaur Venusaur Clefairy Clefable Exeggutor Mew 	0x014BAA88
F4 -EMPTY-	0x00
F5 -EMPTY-	0x00
F6 -EMPTY-	0x00
F7 -EMPTY-	0x00
F8 -EMPTY-	0x00
F9 -EMPTY-	0x00
FA -EMPTY-	0x00
FB -EMPTY-	0x00
FC -EMPTY-	0x00
FD -EMPTY-	0x00
FE -EMPTY-	0x00
